NO ./path_to_north_texture
SO ./path_to_south_texture
WE ./path_to_west_texture
EA ./path_to_east_texture

F 220,100,0
C 225,30,0

          11111111111111111111111111111111111
          10000000000000000000000000000000001
          10110000000000000000000000000000001
          10000000000000000000000000000000001
111111111110000000000000000000000000000000001
100000000000000000000000000000000000000000001
1000000000000000000000000000000001
1000000000000000000000000000000001
1000000000000000000000000000000001
1000000000000000000000000000000001
1000000000000000000000000000000001
1000000000000000000000000000000001
1000000000000000000000000000000001
1000000000000000000000000000000001111
111110111 11001111 100000001 10001
100000001 10000001 100000001 11011
111111111 11111111 111111111 11111