NO ./path_to_north_texture
SO ./path_to_south_texture
WE ./path_to_west_texture
EA ./path_to_east_texture
S ./path_to_sprite

F 220,65,0
C 210,123,0

11111111111111111111111111111111
10000000000000000000000000000001
10000000000000000000000000000001
10000010000000000000000000000001
10000000000000000000000000000001
10000000000000010000000000000001
10000000000000000000000000000001
10000000000000000000000000000001
10000000000000000000000000000001
10000000000000000000000000000001
10000000000000000000000000000001
10000000000000000000000000000001
10000100000000000000000000000001
10000000000000000N00000000000001
10000000000000000000000010000001
10000000000000000000000000000001
10000000000000000000000000000001
11111111111111111111111111111111
