NO ./textures/north.xpm
SO ./textures/south.xpm
WE ./textures/west.xpm
EA ./textures/east.xp
S ./path_to_the_sprite_texture

F 220,    69 , 0
C 210,123      , 0

           111111111111111111111111111111111 
          10000000000000000000000000000000001
          10110000000000000000000000000000001
          10000000000000000000000000000000001
111111111110000000000000000000000000000000001
100000000000000000000000000000000000000000001
100000000000000000000000000000000111111111111
10000000000000000000000N0000000001
1000000000000000000000000000000001
1000000000000000000000000000000001
1000000000000000000000000000000001
1000000000000000000000000000000001
1000000000000000000000000000000001            1111111111
1000000001000000001000000001110001111         1000000001
111110111 11001111 100000001 10001            1111111111
100000001 10000001 100000001 11011
111111111 11111111 111111111 11111

