NO ./textures/north_n.xpm
SO ./textures/south_s.xpm
WE ./textures/west_w.xpm
EA ./textures/east_e.xpm


F 100,    69 , 100
C 100,  0      , 50

           111111111111111111111111111111111 
          10000000000000000000000000000000001
          10110000000000000000000000000000001
          10000000000000000000000000000000001
111111111110000000000000000000000000000000001
100000000000000000000000000000000000000000001
100000000000000000000000000000000111111111111
10000000000000000000000000S0000001    
1000000000000000000000000000000001  
1000000000000000000000000000000001
1000000000000000000000000000000001
1000000000000000000000000000000001
1000000000000000000000000000000001            1111111111
1000000001000000001000000001110001111         1000000001
111110111 11001111 100000001 10001            1111111111
100000001 10000001 100000001 11011
111111111 11111111 111111111 11111

