NO ./textures/north.xpm
SO ./textures/south.xpm
WE ./textures/west.xpm
EA ./textures/east.xpm

F 69,69,69
C 150,0,50

11111111111111111111111111111111
10000000000000000000000000000001
10000000000000000000000000000001
10000010000000000000000100000001
10000000000000000000000000000001
10000000011000010000000000000001
10000000000000000000000000000001
10000000000000000000000000000001 1
10000000001010000000000000000001 N1
10000000000000000000000100000001
10000000000000000000000000000001
10000000000000000000000000000001
10000100000000000000000000000001
10000000000000000000000000000001
10000000000000000000000010000001
10000000000100000000000000000001
10000000000000000000000000000001
11111111111111111111111111111111
